##########################################################################################
#E#      #   #  # #     ##  #     ##   #         #        ## #    #    #   #       #     #
#   ## #   #  #     ###    ## ###    #  ##### ## # #### #     ###   # #  #  # # ## ### # #
# ##S ### # ##  # ##    # #     # # # # #     #  # #   #  ###     # #   # #  #   #   # # #
#   #  #  #   # #  ### #### # #  #  #     ####  #   ##   #   # # # # ###  ## # # # # # ###
## # # # ## #    #    ###    # # # # # # #   # #  #  ####  #  ###        #   # #  ## #   #
#    # #    # ### ###  #  # #   #  #  # #  # #  ## #      # #  #  ## # ##  ##  ## #   ## #
#### #  # ## #    #  # # # #  #  #  #     #   #     # # ##   # # #  #  #  #  ##   # # #  #
#   ### # #    ## # ##   # # # # # #  ## ## #  # ##  #  ## # # #   #  #  #  #   ## ##   ##
# #  #  #   ###   # # # #    # #   ##  #   # # ##  #  #   ## # # # # #  #  #  ##     ##  #
#  #   #  ##   # #     #  # #   ###  #  ## # #    # #  ## #  #  ## #   # #   #   ###   # #
##  ### ##   ##  ## ###  # ## #     ## # # #  # #   # #     # # #   ###    ## ## #  ## # #
#  ##      # #  # # #   ##   # # ####  # #  # #  ## # ## ## #   # ##    # # #    # #     #
##   # # ##  # #    # # #  # #   #    ##  # #  ##   #   #    # ## #  # #  #  # ##   # # ##
# ##  ##   # # # # ##  #  #  # #   ## #  ##  #    ## ## #####  #  ###  # # #   #  #  # # #
#   # #  #  #   ## # # # ###  #  # #    #  #  # #  #  #       #  #   # # #   ##  #  #    #
# # # ### #   #      # #  # # ### #  ##   ###  # #  #  # #####  ## #  ## # #   #  #   ## #
##  #      ### ##### #  #   #      #  # #  #  #   #   # #      #   # #   #  # #  # ## #  #
#  # ## ## #        # #   ## # ### # #  ###  #  # ## #    ## ## # #    ## #  #  #  # #  ##
# ## # # #   ### ## # # ##   ##  # ##  #    ## #   # # ###  #      # ##    #   # #   # # #
#        ## #   #   # #    #    ##   ##  ###   # ##  #    #  ### #  #  ###  ###    # #   #
## # # #   # # #  ##   #### # # # ##   #   # #  #   #  ## ##    # #  #     #  # ###   ## #
#   # # # #     # #  # #     #  # # ## # # # # #  ## ## #   # #     ### ##   #  #  # #   #
### #       # # #  # #   ## ## #     #  ## #  #  #       ## #  # ### ## #  # # #  #    ###
#   ######## ##  #  #  #  #      #### # #  # #  # # ## ##   ##  #       # # #   #  ####  #
# ##           #  #  # ###  # ####      # ##   #    #  #  ##   #  ### ##  #   #  #      ##
#  # # ####### # # #  #   ## #     ### #    # # # # # #  #   ### #  # # ##  ## #  # # # ##
# #   ##     #  #   # # # #   # ###   ## ##  ##    #  # # # ##     ##     # ##  #  #  #  #
#   #    # #  #   #     #   #   #   #      #    ##  #       #  # #   # ##      ###   ### #
##########################################################################################
